28,15
[N][N][N][N][N][N][N][N][N][N][N][N][N][N][N][N][N][N][N][N][N][N][N][N][N][N][N][N]
[N][N][N][N][N][N][N][N][N][N][N][N][N][N][N][N][N][N][N][N][N][N][N][N][N][N][N][N]
[N][N][N][N][N][N][N][N][N][N][N][N][N][N][N][N][N][N][N][N][N][N][N][N][N][N][N][N]
[N][N][N][N][N][N][N][N][N][N][N][N][N][N][N][N][N][N][N][N][N][N][N][N][N][N][N][N]
[N][N][N][N][N][N][N][N][N][N][N][N][N][N][N][N][N][N][N][N][N][N][N][N][N][N][N][N]
[N][N][N][N][N][N][N][N][N][N][N][N][N][N][N][N][N][N][N][N][N][N][N][N][N][N][N][N]
[N][N][N][N][N][N][N][N][N][N][N][N][N][N][N][N][N][N][N][N][N][N][N][N][N][N][N][N]
[N][N][N][N][N][N][N][N][N][N][N][N][N][N][N][N][N][N][N][N][N][N][N][N][N][N][N][N]
[N][N][N][N][N][N][N][N][N][N][N][N][N][N][N][N][N][N][N][N][N][N][N][N][N][N][N][N]
[N][N][N][N][N][N][N][N][N][N][N][N][N][N][N][N][N][N][N][N][N][N][N][N][N][N][N][N]
[N][N][N][N][N][N][N][N][N][N][N][N][N][N][N][N][N][N][N][N][N][N][N][N][N][N][N][N]
[N][N][N][X][N][N][N][N][N][N][N][N][N][N][N][N][N][N][N][N][N][N][N][N][N][N][N][N]
[B][B][B][B][B][B][B][B][B][B][B][B][B][B][B][B][B][B][B][B][B][B][B][B][B][B][B][B]
[B][B][B][B][B][B][B][B][B][B][B][B][B][B][B][B][B][B][B][B][B][B][B][B][B][B][B][B]
[B][B][B][B][B][B][B][B][B][B][B][B][B][B][B][B][B][B][B][B][B][B][B][B][B][B][B][B]